subreddit,able,account,actually,administration,ago,american,aren,away,bad,balance,bank,bankruptcy,based,believe,benefit,best,better,biden,big,borrower,business,buy,car,card,care,career,case,change,class,college,come,company,congress,cost,country,court,credit,day,debt,decision,degree,democrat,did,didn,different,doe,doesn,doing,dollar,don,education,end,exactly,federal,feel,financial,forgive,forgiven,forgiveness,free,fuck,future,getting,going,good,got,government,graduate,great,ha,happen,hard,having,help,high,higher,home,hope,house,idea,idr,income,instead,isn,issue,job,just,kid,know,law,le,left,let,life,like,likely,literally,live,living,ll,loan,lol,long,look,lot,low,lower,major,make,making,maybe,mean,million,minimum,mohela,money,month,monthly,mortgage,need,new,number,old,paid,parent,party,pay,paying,payment,people,person,plan,point,poor,ppp,predatory,president,pretty,price,principal,private,probably,problem,program,pslf,public,rate,real,really,reason,repayment,republican,rich,right,said,save,say,saying,school,score,service,shit,start,started,state,stop,student,sure,taking,tax,term,thing,think,thought,time,took,total,trump,try,trying,tuition,understand,university,use,used,ve,vote,wa,want,way,went,won,work,worked,working,wouldn,yeah,year,yes,zero
AITAH,9,6,11,4,5,0,5,9,7,3,1,2,15,2,1,11,9,1,13,2,2,5,5,3,5,12,4,3,4,43,7,4,1,26,3,0,12,7,192,12,82,0,36,19,5,20,23,5,7,31,47,18,6,20,7,23,2,23,16,7,7,9,15,38,40,18,9,12,9,40,1,5,5,6,19,8,7,2,6,4,0,27,6,13,5,30,57,14,24,6,10,3,8,29,60,10,1,8,12,20,169,9,14,12,27,6,2,5,52,13,9,16,3,7,0,35,17,6,2,14,6,5,5,24,13,0,78,42,34,35,11,30,13,8,0,0,0,13,3,1,23,17,10,15,18,12,6,3,14,9,10,2,14,24,14,1,21,5,63,3,8,5,5,4,25,3,62,17,9,5,1,28,21,15,34,15,3,3,0,0,16,3,19,5,5,13,0,92,26,27,24,14,30,5,14,9,8,131,3,2
Bogleheads,1,18,1,0,1,0,1,1,0,6,2,0,4,1,2,2,3,0,4,1,0,3,3,3,2,3,2,0,0,0,5,1,0,9,0,0,7,3,37,2,5,0,3,1,3,3,2,7,8,16,1,3,5,8,3,6,0,0,1,3,1,4,2,6,4,7,3,0,4,7,1,0,5,3,7,5,1,1,3,1,0,7,4,6,2,12,23,1,6,4,4,2,2,1,20,1,0,2,4,9,84,1,11,3,7,6,1,0,17,5,4,2,0,9,0,23,7,3,3,3,5,3,0,11,0,1,28,16,21,8,0,12,6,1,0,0,0,6,0,3,4,8,0,1,3,2,9,3,5,1,4,0,0,7,2,2,3,1,2,0,1,1,1,2,0,1,34,6,1,16,8,8,8,1,10,3,9,0,1,3,0,2,0,9,2,5,0,10,7,3,2,1,5,2,1,5,5,27,3,1
FluentInFinance,31,7,33,7,12,7,29,14,32,17,114,45,26,10,11,13,35,10,16,44,33,16,29,13,13,15,15,15,27,185,19,19,6,72,16,5,37,14,164,33,116,3,54,48,19,30,59,27,27,132,98,23,23,39,9,34,11,24,55,39,16,30,36,66,45,38,93,18,12,72,15,23,26,25,68,25,14,4,12,24,7,41,23,39,37,40,161,32,65,12,26,4,28,38,133,12,13,4,17,45,751,13,33,22,36,20,8,19,106,39,27,26,7,38,0,158,56,12,40,81,13,16,70,122,20,5,194,108,90,238,22,26,28,35,6,46,1,16,18,34,33,23,47,24,7,18,99,17,36,27,26,10,18,38,10,3,42,24,132,6,9,17,27,6,33,18,283,30,29,31,41,52,52,17,83,29,12,5,14,17,51,55,31,14,15,37,18,161,54,62,37,15,60,9,13,15,34,251,25,12
FunnyandSad,7,6,15,0,10,5,9,4,20,24,35,20,15,4,8,2,11,2,5,3,4,6,8,16,7,3,9,9,23,55,9,7,2,34,11,1,22,9,74,7,16,0,22,23,12,5,20,9,9,64,32,8,11,13,7,20,3,8,11,16,4,5,7,32,21,22,31,16,4,33,6,3,8,11,17,15,3,5,11,3,0,5,12,19,2,19,81,3,26,4,16,7,18,8,60,7,1,0,7,11,306,4,18,7,16,13,10,2,60,18,9,21,7,39,2,53,68,27,27,31,9,6,9,85,5,1,105,64,114,78,16,7,22,7,1,9,1,3,5,65,22,14,17,10,3,5,67,5,20,15,9,2,6,11,6,5,17,10,63,2,5,8,6,10,8,11,120,15,7,9,14,27,26,4,33,14,12,1,3,6,21,24,42,7,9,23,1,90,23,23,13,11,42,0,7,14,12,125,8,7
Law_and_Politics,2,0,11,5,5,11,4,8,2,10,6,23,1,1,4,1,8,22,6,5,14,2,0,0,2,1,2,5,6,20,7,5,6,5,5,7,1,6,52,0,1,4,6,12,0,15,27,10,10,31,21,1,1,1,2,1,0,20,17,9,20,3,6,20,21,14,7,1,6,27,1,4,3,12,10,1,3,3,1,8,0,2,4,13,2,5,44,5,25,4,4,2,13,8,47,1,6,1,0,19,100,8,5,1,8,3,4,2,34,5,5,8,14,0,0,23,2,0,0,19,3,6,5,25,1,5,92,21,4,79,9,9,4,3,36,2,10,3,0,1,1,4,3,5,1,5,1,4,9,1,3,20,10,12,10,4,39,4,11,0,1,15,10,0,7,5,36,14,1,24,2,13,21,6,15,6,2,69,2,3,2,2,4,0,3,6,62,54,27,20,8,11,8,3,5,3,10,19,6,0
MiddleClassFinance,9,2,20,6,10,7,9,6,19,5,10,17,14,5,8,3,8,25,7,3,10,10,1,0,11,3,5,15,22,118,13,6,15,79,11,4,8,9,91,2,25,16,26,17,4,12,27,7,6,58,52,10,7,40,6,9,12,14,49,24,5,18,19,38,23,11,87,10,7,30,6,10,11,19,17,21,4,6,6,14,0,11,13,7,35,29,74,10,20,4,18,18,9,10,65,9,4,6,8,19,288,5,9,9,22,13,15,8,43,20,14,17,10,7,0,64,9,2,4,34,13,10,9,30,2,21,65,23,11,102,11,22,11,10,3,7,14,8,25,6,19,11,36,35,7,38,33,9,17,21,9,28,17,24,9,12,21,7,71,2,11,13,14,5,43,11,177,15,4,19,7,34,26,10,38,7,10,20,11,5,48,8,56,7,16,12,49,84,39,33,12,14,26,7,5,13,10,99,8,4
Money,12,3,5,0,4,29,13,8,10,9,6,1,7,4,4,23,21,3,9,3,11,9,17,0,5,27,8,2,23,151,12,12,0,74,22,2,2,15,93,4,124,0,37,18,13,9,15,12,4,53,38,10,4,12,8,19,0,2,4,21,0,8,22,45,41,36,25,12,8,23,1,11,9,14,30,17,18,2,5,9,0,14,5,15,5,76,78,24,27,6,20,3,6,21,74,4,7,40,36,16,146,11,8,9,27,8,8,14,51,18,5,8,3,10,0,52,19,1,1,31,17,2,9,33,21,5,90,24,11,104,4,20,17,7,0,4,2,14,18,0,18,16,22,11,0,24,13,8,20,8,3,1,4,11,10,9,12,5,125,1,3,9,12,7,58,9,104,11,8,17,1,25,34,4,65,10,5,0,5,7,65,8,84,13,6,12,0,82,34,28,33,6,48,18,24,5,9,171,9,6
OptimistsUnite,6,3,6,2,8,8,3,1,12,2,3,0,2,1,9,3,7,11,5,1,3,3,5,0,4,0,3,3,4,15,5,2,1,15,6,1,1,4,42,8,33,1,41,28,5,7,9,6,6,28,23,6,3,7,4,5,7,35,31,8,4,4,20,15,21,30,50,5,9,12,3,2,2,13,3,3,1,9,3,3,0,6,2,9,5,46,42,3,14,12,3,4,4,5,28,5,8,1,1,7,83,13,7,3,6,7,1,2,22,5,9,9,0,2,3,27,8,2,10,9,1,0,2,25,2,3,58,27,18,48,7,4,8,3,1,2,4,6,2,2,10,4,7,30,22,55,1,1,10,2,0,1,4,9,14,1,13,4,32,0,39,8,1,6,11,4,32,15,3,39,4,9,26,4,18,5,3,9,2,2,11,8,11,6,7,16,1,53,13,12,8,5,35,13,12,2,10,37,6,3
PSLF,5,16,11,24,14,7,3,2,2,45,3,0,0,7,3,15,6,28,1,4,5,5,0,2,5,5,9,8,1,8,10,3,3,3,1,1,16,28,24,3,5,0,48,23,6,19,8,5,7,21,13,9,5,18,11,8,8,51,72,11,0,4,6,16,13,82,17,0,7,35,2,7,5,4,7,3,2,10,2,4,6,13,5,6,4,24,104,7,31,10,6,1,9,4,37,3,7,1,0,16,130,5,9,5,10,2,2,0,32,6,4,12,12,2,60,17,33,3,1,8,15,9,5,22,0,1,31,15,63,51,5,6,14,0,1,3,4,5,0,2,7,3,3,31,81,54,4,3,8,3,6,1,5,15,12,6,18,12,12,0,36,5,1,6,15,3,45,20,4,53,5,12,17,9,31,16,2,15,2,11,2,8,1,3,1,28,5,89,15,10,4,8,37,16,17,4,10,67,17,19
RedditForGrownups,8,1,15,8,4,7,8,7,7,6,16,21,12,7,25,6,8,36,21,19,114,7,7,6,6,2,9,6,26,51,9,23,121,8,3,43,9,3,65,6,18,7,35,43,17,18,20,6,7,38,35,5,8,18,2,9,53,104,110,19,5,2,11,16,15,26,87,7,2,39,7,4,6,30,6,12,8,3,8,9,0,6,7,11,19,13,53,5,17,100,6,2,5,12,42,4,8,1,3,10,567,3,10,5,17,5,3,2,46,6,3,6,6,1,1,67,4,1,3,30,4,4,4,22,0,5,69,11,9,114,7,6,8,29,199,2,48,3,3,2,12,5,7,51,19,20,9,7,26,20,4,20,48,8,14,2,23,7,18,1,14,8,2,5,8,6,282,6,7,13,20,32,22,2,27,23,2,15,4,6,5,6,2,18,19,8,10,215,22,36,19,3,30,10,15,2,4,30,9,0
